10000000001010101010100000000000101010101000100000
11111111101010101010111111101110101010101011101111
10001000000000000000000000101000001000000000101010
11101111101010111111111110111111101110111111101010
10100010101010100000000000100010000000001010001000
10111010111111111010111110111011111110111010111011
10000000000000001010100000000010001010101000001010
10101111111111101111111010111011101010101011111010
10101000000000000010100010100000000000000000001000
11111110111110111010111111111011111011101111111110
10100000100000100000101010000010000010000000101010
10111011111010111110101011101011101111101111101010
100000100000101000000000000010001010000c0000000000
11101011101010101111101110101011111010101010111010
10001010001010101000001000101000100010101010001010
10111111111110111110101010101111111011101010111111
10101010000000100000101010100010000010001010000000
11101011111011111111101111101111101011101110101010
10100010001010000000001000001000001010000010101010
10111011101111111110111110101110101m11101111101110
10100010101010100000100000101000100010001000000010
10111010101010111111111010101011101111111110101010
10000000000000000000000010101010001000000000101010
10111110101010111010101011101111101110101110111111
10100000101010100010101010001000000010101000001010
10101110111010101010111110111110101111111110111010
10101000100010101010100000100000101010000000000000
11111110111010101111111010101010111011111010101010
10000000001010101000000010101010100000000010101010
10111110101111111111111010101110101111101011101010
10100000100010000000000010101000101000001000101010
10101110101111111111101010111110111110101011101111
10101000101010101010001010100010100000101010000000
10111110111010101011101010111011111110101011101010
10100000100000000000001010100000000000101010001010
11111110111011111011101110101011111110111111111011
10000000100010000010000010101010000000000010000000
11111011111011101010101110111110111010101011111011
10000010000000101010100010100000100010101010000000
11111111101011111110101110111111111010101011111011
10000000001000001000100010100000000010101010000000
11101010101010101111101111111011111010101011101010
10001010101010101000001000000010000010101010001010
10101110101010111111101110101010101010111110101110
10101000101010101010001000101010101010001000100010
11111110111011101011101110111110111010101110101011
10100000001010000000001000001000001010101000101000
10111110111011101010101110111010111011101111111011
10000000001010001010101000001010100010000010000000
11111111111111111111111111111111111111111111111111